persistence_list_sync_flag	integer
installation_type	integer
EMS_serial_number	varchar(20)
grid_code	integer
install_done	integer
factory_page_access	integer
qcloud_connected_time	datetime
qcloud_disconnected_time	datetime
firmware_update_state	integer
bdc_operating_id	integer
bdc_operating_count	integer
eos_serial_number	varchar(10)
eos_password	varchar(30)
eos_mq_geni_url	varchar(255)
eos_api_geni_url	varchar(255)
eos_push_gateway_uri	varchar(255)
eos_power_sampling_interval	integer
eos_default_sampling_interval	integer
web_engineer_password	varchar(100)
web_factory_password	varchar(100)
web_installer_password	varchar(100)
web_service_password	varchar(100)
web_installer_temp_password	varchar(100)
web_installer_temp_password_setting_time	integer
web_third_party_password	varchar(100)
ems_protection_lock_flag	integer
meter_fault_occurrence_time1	integer
meter_fault_occurrence_time2	integer
meter_fault_occurrence_time3	integer
battery_backup_soc	integer
energy_policy	integer
country_code	integer
timezone	text
language_code	integer
Inverter_limit	integer
grid_target_frequency	real
external_generator_mode_flag	integer
permit_service_mode_select_flag	integer
enter_service_randomized_delay_flag	integer
multiple_earthed_neutral_system_flag	integer
randomized_delay_time	integer
inverter_import_power_limit	integer
inverter_export_power_limit	integer
battery_charge_limit	integer
battery_discharge_limit	integer
logic_interface_flag	integer
PV_type	integer
installed_PV_count	integer
installed_PV1_power	integer
installed_PV2_power	integer
installed_PV3_power	integer
installed_PV4_power	integer
installed_PV5_power	integer
feed_in_limit	integer
feed_in_limit_w	integer
pv_module_count	integer
module_power_class	integer
total_capacity_calc_option	integer
meter_model	integer
meter_conn	integer
meter_tcp_ip	varchar(20)
meter_tcp_port	integer
meter_rtu_Dev	varchar(20)
meter_rtu_baudrate	integer
meter_rtu_parity	integer
meter_rtu_data	integer
meter_rtu_stop	integer
meter_load_from_gw	integer
meter_model_pv	integer
meter_conn_pv	integer
meter_tcp_ip_pv	varchar(20)
meter_tcp_port_pv	integer
meter_rtu_Dev_pv	varchar(20)
meter_rtu_baudrate_pv	integer
meter_rtu_parity_pv	integer
meter_rtu_data_pv	integer
meter_rtu_stop_pv	integer
meter_load_from_gw_pv	integer
pv_connection_type	integer
third_party_inverter_exist	integer
operating_rack_count	integer
installed_rack_count	integer
battery_setting_mode	integer
rack1_model	integer
rack1_capacity	real
rack1_module_count	integer
rack1_module1_sz	varchar(20)
rack1_module2_sz	varchar(20)
rack1_module3_sz	varchar(20)
rack1_module4_sz	varchar(20)
rack1_module5_sz	varchar(20)
rack2_model	integer
rack2_capacity	real
rack2_module_count	integer
rack2_module1_sz	varchar(20)
rack2_module2_sz	varchar(20)
rack2_module3_sz	varchar(20)
rack2_module4_sz	varchar(20)
rack2_module5_sz	varchar(20)
rack3_model	integer
rack3_capacity	real
rack3_module_count	integer
rack3_module1_sz	varchar(20)
rack3_module2_sz	varchar(20)
rack3_module3_sz	varchar(20)
rack3_module4_sz	varchar(20)
rack3_module5_sz	varchar(20)
gateway_conn	integer
gateway_tcp_port	integer
gateway_rtu_dev	varchar(20)
gateway_rtu_baudrate	integer
gateway_rtu_parity	integer
gateway_rtu_data	integer
gateway_rtu_stop	integer
dc_src_conn	integer
dc_src_tcp_ip	varchar(20)
dc_src_tcp_port	integer
dc_src_rtu_dev	varchar(20)
dc_src_rtu_baudrate	integer
dc_src_rtu_parity	integer
dc_src_rtu_data	integer
dc_src_rtu_stop	integer
tou_info_count	integer
tou_info_section1_time	varchar(6)
tou_info_section1_action	integer
tou_info_section1_inverter_ref	integer
tou_info_section1_tariff	integer
tou_info_section2_time	varchar(6)
tou_info_section2_action	integer
tou_info_section2_inverter_ref	integer
tou_info_section2_tariff	integer
tou_info_section3_time	varchar(6)
tou_info_section3_action	integer
tou_info_section3_inverter_ref	integer
tou_info_section3_tariff	integer
tou_info_section4_time	varchar(6)
tou_info_section4_action	integer
tou_info_section4_inverter_ref	integer
tou_info_section4_tariff	integer
tou_info_section5_time	varchar(6)
tou_info_section5_action	integer
tou_info_section5_inverter_ref	integer
tou_info_section5_tariff	integer
tou_info_section6_time	varchar(6)
tou_info_section6_action	integer
tou_info_section6_inverter_ref	integer
tou_info_section6_tariff	integer
tou_info_section7_time	varchar(6)
tou_info_section7_action	integer
tou_info_section7_inverter_ref	integer
tou_info_section7_tariff	integer
tou_info_section8_time	varchar(6)
tou_info_section8_action	integer
tou_info_section8_inverter_ref	integer
tou_info_section8_tariff	integer
tou_info_section9_time	varchar(6)
tou_info_section9_action	integer
tou_info_section9_inverter_ref	integer
tou_info_section9_tariff	integer
tou_info_section10_time	varchar(6)
tou_info_section10_action	integer
tou_info_section10_inverter_ref	integer
tou_info_section10_tariff	integer
tou_info_section11_time	varchar(6)
tou_info_section11_action	integer
tou_info_section11_inverter_ref	integer
tou_info_section11_tariff	integer
tou_info_section12_time	varchar(6)
tou_info_section12_action	integer
tou_info_section12_inverter_ref	integer
tou_info_section12_tariff	integer
tou_info_section13_time	varchar(6)
tou_info_section13_action	integer
tou_info_section13_inverter_ref	integer
tou_info_section13_tariff	integer
tou_info_section14_time	varchar(6)
tou_info_section14_action	integer
tou_info_section14_inverter_ref	integer
tou_info_section14_tariff	integer
tou_info_section15_time	varchar(6)
tou_info_section15_action	integer
tou_info_section15_inverter_ref	integer
tou_info_section15_tariff	integer
tou_info_section16_time	varchar(6)
tou_info_section16_action	integer
tou_info_section16_inverter_ref	integer
tou_info_section16_tariff	integer
tou_info_section17_time	varchar(6)
tou_info_section17_action	integer
tou_info_section17_inverter_ref	integer
tou_info_section17_tariff	integer
tou_info_section18_time	varchar(6)
tou_info_section18_action	integer
tou_info_section18_inverter_ref	integer
tou_info_section18_tariff	integer
tou_info_section19_time	varchar(6)
tou_info_section19_action	integer
tou_info_section19_inverter_ref	integer
tou_info_section19_tariff	integer
tou_info_section20_time	varchar(6)
tou_info_section20_action	integer
tou_info_section20_inverter_ref	integer
tou_info_section20_tariff	integer
tou_info_section21_time	varchar(6)
tou_info_section21_action	integer
tou_info_section21_inverter_ref	integer
tou_info_section21_tariff	integer
tou_info_section22_time	varchar(6)
tou_info_section22_action	integer
tou_info_section22_inverter_ref	integer
tou_info_section22_tariff	integer
tou_info_section23_time	varchar(6)
tou_info_section23_action	integer
tou_info_section23_inverter_ref	integer
tou_info_section23_tariff	integer
tou_info_section24_time	varchar(6)
tou_info_section24_action	integer
tou_info_section24_inverter_ref	integer
tou_info_section24_tariff	integer
tou_info_section25_time	varchar(6)
tou_info_section25_action	integer
tou_info_section25_inverter_ref	integer
tou_info_section25_tariff	integer
tou_info_section26_time	varchar(6)
tou_info_section26_action	integer
tou_info_section26_inverter_ref	integer
tou_info_section26_tariff	integer
tou_info_section27_time	varchar(6)
tou_info_section27_action	integer
tou_info_section27_inverter_ref	integer
tou_info_section27_tariff	integer
tou_info_section28_time	varchar(6)
tou_info_section28_action	integer
tou_info_section28_inverter_ref	integer
tou_info_section28_tariff	integer
tou_info_section29_time	varchar(6)
tou_info_section29_action	integer
tou_info_section29_inverter_ref	integer
tou_info_section29_tariff	integer
tou_info_section30_time	varchar(6)
tou_info_section30_action	integer
tou_info_section30_inverter_ref	integer
tou_info_section30_tariff	integer
tou_info_count_weekend	integer
tou_info_section1_time_weekend	varchar(6)
tou_info_section1_action_weekend	integer
tou_info_section1_inverter_ref_weekend	integer
tou_info_section1_tariff_weekend	integer
tou_info_section2_time_weekend	varchar(6)
tou_info_section2_action_weekend	integer
tou_info_section2_inverter_ref_weekend	integer
tou_info_section2_tariff_weekend	integer
tou_info_section3_time_weekend	varchar(6)
tou_info_section3_action_weekend	integer
tou_info_section3_inverter_ref_weekend	integer
tou_info_section3_tariff_weekend	integer
tou_info_section4_time_weekend	varchar(6)
tou_info_section4_action_weekend	integer
tou_info_section4_inverter_ref_weekend	integer
tou_info_section4_tariff_weekend	integer
tou_info_section5_time_weekend	varchar(6)
tou_info_section5_action_weekend	integer
tou_info_section5_inverter_ref_weekend	integer
tou_info_section5_tariff_weekend	integer
tou_info_section6_time_weekend	varchar(6)
tou_info_section6_action_weekend	integer
tou_info_section6_inverter_ref_weekend	integer
tou_info_section6_tariff_weekend	integer
tou_info_section7_time	varchar(6)
tou_info_section7_action	integer
tou_info_section7_inverter_ref	integer
tou_info_section7_tariff	integer
tou_info_section8_time	varchar(6)
tou_info_section8_action	integer
tou_info_section8_inverter_ref	integer
tou_info_section8_tariff	integer
tou_info_section9_time	varchar(6)
tou_info_section9_action	integer
tou_info_section9_inverter_ref	integer
tou_info_section9_tariff	integer
tou_info_section10_time	varchar(6)
tou_info_section10_action	integer
tou_info_section10_inverter_ref	integer
tou_info_section10_tariff	integer
tou_info_section11_time	varchar(6)
tou_info_section11_action	integer
tou_info_section11_inverter_ref	integer
tou_info_section11_tariff	integer
tou_info_section12_time	varchar(6)
tou_info_section12_action	integer
tou_info_section12_inverter_ref	integer
tou_info_section12_tariff	integer
tou_info_section13_time	varchar(6)
tou_info_section13_action	integer
tou_info_section13_inverter_ref	integer
tou_info_section13_tariff	integer
tou_info_section14_time	varchar(6)
tou_info_section14_action	integer
tou_info_section14_inverter_ref	integer
tou_info_section14_tariff	integer
tou_info_section15_time	varchar(6)
tou_info_section15_action	integer
tou_info_section15_inverter_ref	integer
tou_info_section15_tariff	integer
tou_info_section16_time	varchar(6)
tou_info_section16_action	integer
tou_info_section16_inverter_ref	integer
tou_info_section16_tariff	integer
tou_info_section17_time	varchar(6)
tou_info_section17_action	integer
tou_info_section17_inverter_ref	integer
tou_info_section17_tariff	integer
tou_info_section18_time	varchar(6)
tou_info_section18_action	integer
tou_info_section18_inverter_ref	integer
tou_info_section18_tariff	integer
tou_info_section19_time	varchar(6)
tou_info_section19_action	integer
tou_info_section19_inverter_ref	integer
tou_info_section19_tariff	integer
tou_info_section20_time	varchar(6)
tou_info_section20_action	integer
tou_info_section20_inverter_ref	integer
tou_info_section20_tariff	integer
tou_info_section21_time	varchar(6)
tou_info_section21_action	integer
tou_info_section21_inverter_ref	integer
tou_info_section21_tariff	integer
tou_info_section22_time	varchar(6)
tou_info_section22_action	integer
tou_info_section22_inverter_ref	integer
tou_info_section22_tariff	integer
tou_info_section23_time	varchar(6)
tou_info_section23_action	integer
tou_info_section23_inverter_ref	integer
tou_info_section23_tariff	integer
tou_info_section24_time	varchar(6)
tou_info_section24_action	integer
tou_info_section24_inverter_ref	integer
tou_info_section24_tariff	integer
tou_info_section25_time	varchar(6)
tou_info_section25_action	integer
tou_info_section25_inverter_ref	integer
tou_info_section25_tariff	integer
tou_info_section26_time	varchar(6)
tou_info_section26_action	integer
tou_info_section26_inverter_ref	integer
tou_info_section26_tariff	integer
tou_info_section27_time	varchar(6)
tou_info_section27_action	integer
tou_info_section27_inverter_ref	integer
tou_info_section27_tariff	integer
tou_info_section28_time	varchar(6)
tou_info_section28_action	integer
tou_info_section28_inverter_ref	integer
tou_info_section28_tariff	integer
tou_info_section29_time	varchar(6)
tou_info_section29_action	integer
tou_info_section29_inverter_ref	integer
tou_info_section29_tariff	integer
tou_info_section30_time	varchar(6)
tou_info_section30_action	integer
tou_info_section30_inverter_ref	integer
tou_info_section30_tariff	integer
tou_info_start_date	varchar(9)
tou_info_end_date	varchar(9)
advanced_tou_flag	integer
dynamic_optimizer	integer
eos_mode_flag	integer
echonet_lite_flag	integer
jet_scheduler_flag	integer
sg_ready_flag	integer
heatpump_consumption_power	integer
mlpe_conn	integer
mlpe_rtu_dev	varchar(20)
mlpe_rtu_baudrate	integer
mlpe_rtu_parity	integer
mlpe_rtu_data	integer
mlpe_rtu_stop	integer
sec_ems_tcp_ip	varchar(20)
sec_ems_tcp_port	integer
sec_ems_server_id	integer
hub_installed	integer
cloud_url	varchar(255)
cloud_port	integer
sftp_address	varchar(30)
pcs_conn	integer
pcs_can_interface	varchar(20)
pcs_connection_mode	integer
ext_ems_tcp_ip	varchar(20)
ext_ems_tcp_port	integer
ext_ems_rtu_dev	varchar(20)
ext_ems_rtu_baudrate	integer
ext_ems_rtu_parity	integer
ext_ems_rtu_data	integer
ext_ems_rtu_stop	integer
ext_ems_model	integer
pcs_debug_mode	integer
ext_ems_server_id	integer
battery_user_soc_min	integer
battery_user_soc_max	integer
battery_hysteresis_low	integer
battery_hysteresis_high	integer
processmgr_debug_level	integer
systemlog_debug_level	integer
fota_debug_level	integer
powercontrol_debug_level	integer
algorithmmgr_debug_level	integer
essmgr_debug_level	integer
dcsourcemgr_debug_level	integer
cloudmgr_debug_level	integer
metermgr_debug_level	integer
gatewaymgr_debug_level	integer
datamgr_debug_level	integer
dbmgr_debug_level	integer
webengine_debug_level	integer
gqa_debug_level	integer
mlpemgr_debug_level	integer
sysmgr_debug_level	integer
powerscheduler_debug_level	integer
echonetmgr_debug_level	integer
energylink_debug_level	integer
diagmonitor_debug_level	integer
auto_firmware_update_flag	integer
over_volt_detect_level1	real
over_volt_detect_time1	integer
over_volt_detect_level2	real
over_volt_detect_time2	integer
over_volt_detect_level3	real
over_volt_detect_time3	integer
over_volt_detect_level4	real
over_volt_detect_time4	integer
over_volt_detect_level5	real
over_volt_detect_time5	integer
over_volt_release_level	real
over_volt_release_time	integer
volt_detect_level_10minute	real
under_volt_detect_level1	real
under_volt_detect_time1	integer
under_volt_detect_level2	real
under_volt_detect_time2	integer
under_volt_detect_level3	real
under_volt_detect_time3	integer
under_volt_detect_level4	real
under_volt_detect_time4	integer
under_volt_detect_level5	real
under_volt_detect_time5	integer
under_volt_release_level	real
under_volt_release_time	integer
over_freq_detect_level1	real
over_freq_detect_time1	integer
over_freq_detect_level2	real
over_freq_detect_time2	integer
over_freq_detect_level3	real
over_freq_detect_time3	integer
over_freq_detect_level4	real
over_freq_detect_time4	integer
over_freq_detect_level5	real
over_freq_detect_time5	integer
over_freq_release_level	real
over_freq_release_time	integer
under_freq_detect_level1	real
under_freq_detect_time1	integer
under_freq_detect_level2	real
under_freq_detect_time2	integer
under_freq_detect_level3	real
under_freq_detect_time3	integer
under_freq_detect_level4	real
under_freq_detect_time4	integer
under_freq_detect_level5	real
under_freq_detect_time5	integer
under_freq_release_level	real
under_freq_release_time	integer
actpwr_setpoint_flag	integer
actpwr_setpoint_value	float
actpwr_freq_flag	integer
actpwr_freq_sl	real
actpwr_freq_sh	real
actpwr_freq_x1	real
actpwr_freq_x2	real
actpwr_freq_x3	real
actpwr_freq_x4	real
actpwr_freq_x5	real
actpwr_freq_x6	real
actpwr_slope_flag	integer
actpwr_of_pref_flag	integer
actpwr_of_hysteresis_freq	real
actpwr_of_hysteresis_time	integer
actpwr_uf_pref_flag	integer
actpwr_uf_hysteresis_freq	real
actpwr_uf_hysteresis_time	integer
actpwr_p_freq_response_time	integer
actpwr_volt_flag	integer
actpwr_volt_x1	real
actpwr_volt_y1	real
actpwr_volt_x2	real
actpwr_volt_y2	real
actpwr_volt_x3	real
actpwr_volt_y3	real
actpwr_volt_x4	real
actpwr_volt_y4	real
actpwr_p_v_response_time	integer
actpwr_hysteresis_select_flag	integer
actpwr_freq_droop_kof	real
actpwr_freq_droop_kuf	real
reactpwr_cospi_setpoint_flag	integer
reactpwr_cospi_setpoint_excited_flag	integer
reactpwr_cospi_setpoint_value	real
reactpwr_cospi_setpoint_response_time	integer
reactpwr_cospi_p_flag	integer
reactpwr_cospi_p_excited_flag	integer
reactpwr_cospi_p_x1	real
reactpwr_cospi_p_y1	real
reactpwr_cospi_p_x2	real
reactpwr_cospi_p_y2	real
reactpwr_cospi_p_x3	real
reactpwr_cospi_p_y3	real
reactpwr_cospi_p_response_time	integer
reactpwr_q_setpoint_flag	integer
reactpwr_q_setpoint_excited_flag	integer
reactpwr_q_setpoint_value	real
reactpwr_q_setpoint_response_time	integer
reactpwr_q_u_flag	integer
reactpwr_q_u_fixed_vref_select_flag	integer
reactpwr_q_u_vref_voltage	real
reactpwr_auto_vref_avg_time	real
reactpwr_q_u_x1	real
reactpwr_q_u_y1	real
reactpwr_q_u_x2	real
reactpwr_q_u_y2	real
reactpwr_q_u_x3	real
reactpwr_q_u_y3	real
reactpwr_q_u_x4	real
reactpwr_q_u_y4	real
reactpwr_q_u_response_time	integer
reactpwr_q_p_flag	integer
reactpwr_q_p_gen_x1	real
reactpwr_q_p_gen_y1	real
reactpwr_q_p_gen_x2	real
reactpwr_q_p_gen_y2	real
reactpwr_q_p_gen_x3	real
reactpwr_q_p_gen_y3	real
reactpwr_q_p_load_x1	real
reactpwr_q_p_load_y1	real
reactpwr_q_p_load_x2	real
reactpwr_q_p_load_y2	real
reactpwr_q_p_load_x3	real
reactpwr_q_p_load_y3	real
reactpwr_q_p_response_time	integer
reactpwr_q_setpoint_power_mode	integer
reactpwr_q_u_power_mode	integer
reactpwr_q_p_power_mode	integer
reactpwr_q_setpoint_power_priority	integer
reactpwr_q_u_power_priority	integer
reactpwr_q_p_power_priority	integer
reactpwr_cospi_setpoint_power_priority	integer
dc_injection_detect_flag	integer
dc_injection_detect_level1	real
dc_injection_detect_time1	integer
dc_injection_detect_level2	real
dc_injection_detect_time2	integer
dc_injection_control_flag	integer
dc_injection_control_level	real
rcmu_sudden_flag	integer
rcmu_sudden_detect_level1	integer
rcmu_sudden_detect_time1	integer
rcmu_sudden_detect_level2	integer
rcmu_sudden_detect_time2	integer
rcmu_sudden_detect_level3	integer
rcmu_sudden_detect_time3	integer
rcmu_cont_flag	integer
rcmu_cont_detect_level	integer
rcmu_cont_detect_time	integer
pv_insulation_flag	integer
pv_insulation_fault_level	real
pv_insulation_check_cnt	integer
pv_insulation_time	integer
anti_islanding_active_method_detect_flag	integer
anti_islanding_passive_method_detect_flag	integer
anti_islanding_freq_feedback_function_flag	integer
anti_islanding_step_injection_function_flag	integer
anti_islanding_react_power_suppr_function_flag	integer
anti_islanding_gain1	integer
anti_islanding_gain2	integer
anti_islanding_freq_feedback_qmax	real
anti_islanding_step_injection_qmax	real
gradient_flag	integer
gradient_energy_src_enable_flag	integer
gradient_actpwr_setpoint_gradient	real
gradient_actpwr_gradient	real
gradient_unit_reference_select	integer
derating_flag	integer
derating_start_temp	real
derating_value	real
feed_in_relay_flag	integer
feed_in_relay1_attach_level	integer
feed_in_relay1_detach_level	integer
feed_in_relay2_attach_level	integer
feed_in_relay2_detach_level	integer
feed_in_relay3_attach_level	integer
feed_in_relay3_detach_level	integer
feed_in_relay4_attach_level	integer
feed_in_relay4_detach_level	integer
reconnect_delay_time	integer
tau_coefficient	real
invctrl_grid_target_voltage	real
invctrl_grid_target_voltage_offset	real
invctrl_pcs_max_apparent_power_limit	integer
invctrl_var_action	integer
invctrl_pcs_varmax_q1	integer
invctrl_pcs_varmax_q2	integer
invctrl_pcs_varmax_q3	integer
invctrl_pcs_varmax_q4	integer
invctrl_pcs_pfmin_q1	real
invctrl_pcs_pfmin_q2	real
invctrl_pcs_pfmin_q3	real
invctrl_pcs_pfmin_q4	real
invctrl_charge_rate_setting	integer
invctrl_discharge_rate_setting	integer
invctrl_charge_rate_va_setting	integer
invctrl_actpwr_setting	integer
invctrl_actpwr_over_excited_setting	integer
invctrl_actpwr_under_excited_setting	integer
invctrl_export_pmin	real
invctrl_import_pmin	real
dynamic_reactcur_argrasag	real
dynamic_reactcur_argraswell	real
dynamic_reactcur_db_v_min	real
dynamic_reactcur_db_v_max	real
dynamic_reactcur_flag	integer
dynamic_reactcur_argramod	integer
dynamic_reactcur_hold_tmms	integer
dynamic_reactcur_filter_tms 	integer
frt_hvrt_flag	integer
frt_lvrt_flag	integer
frt_hfrt_flag	integer
frt_lfrt_flag	integer
frt_hvrt_start_level	real
frt_lvrt_start_level	real
frt_hfrt_start_level	real
frt_lfrt_start_level	real
volt_rise_suppr_vref	real
volt_rise_suppr_delay_time	real
volt_rise_suppr_max_pf	real
volt_rise_suppr_pf_response_time	real
volt_rise_suppr_min_active_power	real
volt_rise_suppr_active_power_response_time	real
volt_rise_suppr_release_time	real
volt_rise_suppr_flag	integer
export_hard_limit_flag	integer
export_soft_limit_flag	integer
export_hard_limit_level	integer
export_soft_limit_level	integer
export_hard_limit_time	integer
export_soft_limit_time	integer
generation_hard_limit_flag	integer
generation_soft_limit_flag	integer
generation_hard_limit_level	integer
generation_soft_limit_level	integer
generation_hard_limit_time	integer
generation_soft_limit_time	integer
customer_export_limit	integer
customer_import_limit	integer
fcas_flag	integer
fcas_response_capacity_limit	integer
fcas_droop_rate_raise	real
fcas_droop_rate_lower	real
fcas_oftb_max	real
fcas_oftb_min	real
fcas_fr_max	real
fcas_fr_min	real
fcas_nofb_max	real
fcas_nofb_min	real
fcas_test_mode	integer
esm_flag	integer
esm_limit_level	integer
user_rsd	integer
dc_opt_modbus_id	integer
mst_tx_gain	integer
slv_tx_gain	integer
echo_fit_contract_type	integer
echo_total_pv_amount_wh	integer
echo_total_pv_amount_offset_wh	integer
echo_total_feedin_amount_wh	integer
echo_total_feedin_amount_offset_wh	integer
echo_total_batt_disch_amout_wh	integer
echo_total_batt_disch_amout_offset_wh	integer
echo_total_batt_chg_amout_wh	integer
echo_total_batt_chg_amout_offset_wh	integer
ul1741sb_flag	integer
afci_enable_flag_ch1	integer
afci_enable_flag_ch2	integer
afci_enable_flag_ch3	integer
afci_arc_energy_region	integer
afci_time_area_threshold_gain_ch1	integer
afci_freq_area_threshold_gain_ch1	integer
afci_freq_area_threshold_percent_ch1	integer
afci_time_area_threshold_gain_ch2	integer
afci_freq_area_threshold_gain_ch2	integer
afci_freq_area_threshold_percent_ch2	integer
afci_time_area_threshold_gain_ch3	integer
afci_freq_area_threshold_gain_ch3	integer
afci_freq_area_threshold_percent_ch3	integer
mi_nameplate_ratings_vmax	float
mi_nameplate_ratings_vmin	float
mi_nameplate_ratings_amax	float
mi_pv_settings_vpv_min	integer
mi_pv_settings_vpv_max	integer
mi_pv_settings_ipv_max	integer
mi_pv_settings_temp_max	integer
mi_pv_settings_temp_min	integer
mi_flag_nr_config_ena	integer
mi_pv_settings_pow_calib	integer
mi_gfdi_ena	integer
mi_es_rmp_tms	float
mi_rmp_ena	integer
mi_w_rmp	float
mi_watt_set_mod	integer
mi_w_rmp_ref	integer
mi_der_trip_lv_crv_mom_cess_pt_v1	float
mi_der_trip_hv_crv_mom_cess_pt_v1	float
mi_der_freq_droop_freq_watt_pmax	float
mi_der_freq_droop_ctl_pmin	float
mi_flag_dyn_curr_event_base_ena	integer